everyone	每个人
keep	保持
an	一
eye	眼
on	在……之上
in	在……里
case	例子
he	他
start	开始
swell	肿胀
do	做	确实
done	完成
got	得到
get	得到
it	它
okay	好的
this	这
place	地方
look	看
pretty	非常
good	好
piece	块
cake	蛋糕
what	什么
talk	说